25,25
1111111111111111111111111
1000002000001000000000001
1000000000001310000000001
1000000000001410000000001
1000000000001110000000001
1000000000000000000000001
1000000000000000000000001
1000000000000000000000001
1000000000000000000000001
1000000000000000000000001
1000000000000000000000001
1000000000000000000000001
1000000000000000000000001
1000000000000000000000001
1000000000000000000000001
1000000000000000000000001
1000000000000000000000001
1000000000000000000000001
1000000000000000000000001
1000000000000000000020001
1110111111110000000000001
1000000020010000000000001
1020011111110000000000001
1000510000000000000000001
1111111111111111111111111

// these lines will be ignored
0 = empty
1 = wall
2 = enemy
3 = key
4 = chip (item)
5 = portal (level end)