25,25
1111111111111111111111111
1000002000001090000000001
1000000000001r10000000001
1000000000001410000000001
1000000000001110000000001
1111111111100000000000001
1000000000100001111110001
1000000000700001g00000001
100r000000100001110000001
1000000000100000000000001
1000000000100000000000001
1000000000100000000000001
1000000000100000000000001
1000000000100000000000001
1000000000100000000000001
1000001111100000000000001
1000001000600000000000001
1000001000100000000000001
1000001202100000000000001
10000012b2110000000020001
1116111111110000000000001
1000000020010000000000001
1020011111110000000000001
1000510000000000000000001
1111111111111111111111111

// these lines will be ignored
0 = empty
1 = wall
2 = enemy
3 = red key
4 = chip (item)
5 = portal (level end)
6 = Red Key Wall
7 = Blue Key Wall
8 = Yellow Key Wall
9 = Green Key Wall
r = red Key
b = blue key
y = yellow key
g = green key