25,25
1111111111111111111111111
1000002000001000000000001
1000000000001310000000001
1000000000001410000000001
1000000000001110000000001
1000000000000000000000001
1000000000000000000000001
1000000000000000000000001
1000000000000000000000001
1000000000000000000000001
1000000000000000000000001
1000000000000000000000001
1000000000000000000000001
1000000000000000000000001
1000000000000000000000001
1000000000000000000000001
1000000000000000000000001
1000000000000000000000001
1000000000000000000000001
1000000000000000000020001
1000000000000000000000001
1000000020000000000000001
1000000000000000000000001
1000000000000000000000001
1111111111111111111111111

// these lines will be ignored
0 = empty
1 = wall
2 = enemy
3 = key
4 = chip (item)